##########
#.....SEE#
#M.....S.#
#P.......#
##########